{
  "1": "珠海",
  "4": "茂名",
  "5": "湛江",
  "6": "河源",
  "8": "佛山",
  "9": "清远"
}
